## Title: DiCaprio finally wins best actor Oscar
## Section: Breaking News
## Date: 29 February 2016 03:50 pm

DiCaprio finally wins best actor Oscar


	

Leonardo DiCaprio has finally won his first Oscar for survival epic The Revenant, after six nominations, the BBC reported today.


He was named best actor at the 88th Academy Awards, with Brie Larson named best actress for Room.


Spotlight took home the best picture Oscar with Mad Max: Fury Road picking up the most awards of the night, with six accolades.


Mark Rylance won the best supporting actor Oscar, with fellow Briton Sam Smith winning best original song.



The winners of the 88th annual Academy Awards

Best Picture: “Spotlight”

Direction: “The Revenant,” Alejandro G. Iñárritu

Actor: Leonardo DiCaprio, “The Revenant”

Actress: Brie Larson, “Room”

Supporting Actor: Mark Rylance, “Bridge of Spies”

Supporting Actress: Alicia Vikander, “The Danish Girl”

Adapted Screenplay: “The Big Short,” Charles Randolph and Adam McKay

Original Screenplay: “Spotlight,” Josh Singer and Tom McCarthy

Cinematography: “The Revenant,” Emmanuel Lubezki

Production Design: “Mad Max: Fury Road,” Colin Gibson and Lisa Thompson (set decoration)

Film Editing: “Mad Max: Fury Road,” Margaret Sixel

Visual Effects: “Ex Machina,” Andrew Whitehurst, Paul Norris, Mark Ardington and Sara Bennett

Costume Design: “Mad Max: Fury Road,” Jenny Beavan

Makeup: “Mad Max: Fury Road,” Lesley Vanderwalt, Elka Wardega and Damian Martin

Sound Editing: “Mad Max: Fury Road,” Mark Mangini and David White

Sound Mixing: “Mad Max: Fury Road,” Chris Jenkins, Gregg Rudloff and Ben Osmo

Score: “The Hateful Eight,” Ennio Morricone

Song: “Writing’s on the Wall,” from “Spectre,” Jimmy Napes and Sam Smith

Foreign Language Film: “Son of Saul” (Hungary)

Animated Feature: “Inside Out”

Documentary Feature: “Amy”

Animated Short: “Bear Story”

Documentary Short: “A Girl in the River: The Price of Forgiveness”

Live Action Short: “Stutterer”

 
 

		